11111111
10000001
100P0001
10000001
10000001
10000001
100C00E1
11111111